################
################
#P#S   F #     #
#M###### # ### #
#              #
########F# ### #
#        # # S #
###### ### #####
#   S  ###   F #
########## ### #
#C           # #
################
