################
#S#      #     #
# ###### # ### #
#            ###
######## ##    #
#        ## ####
###### #### ####
#      ####    #
############## #
#$             #
################
