################
################
#P#      #     #
#M###### # ### #
#            ###
######## ##    #
#  F     ## ####
###### #### ####
#   S  ####    #
############## #
#C             #
################
