################
#P#      #     #
#S###### # ### #
#            ###
######## ##    #
#        ## ####
###### #### ####
#   B  ####    #
############## #
#$             #
################
