################
#S#      #     #
# ###### # ### #
#          S ###
######## ##    #
#        ## ####
###### #### ####
#   B  ####    #
############## #
#$             #
################
